
# custom continents
breuvran = {
	2200 2201 2202 2203 2204 2205 2206 2207 2208 2209 2210 2211 2212 2213 2214 2215 2216 2217 2218 2219 2220 2221 2222 2223 2224 2225 2226 2227 2228 2229 2230 2231 2232 2233 2234 2235 2236 2237 2238 2239 2240 2241 2242 2243 2244 2245 2246 2247 2248 2249 2250 2251 2252 2253 2254 2255 2256 2257 2258 2259 2260 2261 2262 2263 2264 2265 2266 2267 2268 2269 2270 2271 2272 2273 2274 2275 2276 2277 2278 2279 2280 2281 2282 2283 2284 2285 2286 2287 2288 2289 2290 2291 2292 2293 2294 2295 2296 2297 2298 2299 2300 2301 2302 2303 2304 2305 2306 2307 2308 2309 2310 2311 2312 2313 2314 2315 2316 2317 2318 2319 2320 2321 2322 2323 2324 2325 2326 2327 2328 2329 2330 2331 2332 2333 2334 2335 2336 2337 2338 2339 2340 2341 2342 2343 2344 2345 2346 2347 2348 2349 2350 2351 2352 2353 2354 2355 2356 2357 2358 2359 2360 2361 2362 2363 2364 2365 2366 2367 2368 2369 2370 2371 2372 2373 2374 2375 2376 2377 2378 2379 2380 2381 2382 2383 2384 2385 2386 2387 2388 2389 2390 2391 2392 2393 2394 2395 2396 2397 2398 2399 2400 2401 2934 2989 3002 3010 3032 3042 3050
}
teras = {
	276 288 289 316 321 354 374 377 384 406 435 439 444 448 465 482 491 492 494 501 506 518 526 528 531 535 541 542 550 554 562 565 597 601 608 609 610 624 626 627 630 633 642 654 657 662 668 676 677 682 686 687 703 729 739 742 748 749 766 775 779 808 814 825 827 834 839 844 845 850 878 897 902 906 911 921 931 936 937 938 939 946 947 949 956 959 975 987 990 991 992 994 995 1005 1014 1016 1021 1025 1035 1043 1068 1071 1076 1091 1094 2963 2965 2966 2972 2983 2991 3003 3004 3014 3017 3021 3036 3040 24 25 31 37 44 47 49 52 57 68 72 73 75 78 79 80 81 82 84 86 88 89 92 97 101 103 105 106 107 109 113 116 118 119 122 123 125 132 133 135 148 151 163 164 177 178 180 187 189 190 196 198 216 217 226 231 246 251 253 267 274 275 278 282 294 306 312 319 334 349 357 364 366 373 393 394 405 412 417 456 519 523 532 540 547 762 768 784 802 890 901 920 929 1018 1022 1088 30 36 38 63 64 65 74 76 85 87 90 91 94 96 102 104 114 115 117 121 124 126 131 137 139 143 144 145 146 147 152 153 154 155 156 158 159 160 165 166 167 169 171 174 179 182 183 184 186 193 197 199 200 201 203 205 206 207 208 210 211 212 213 214 218 221 222 225 230 232 233 235 236 238 240 241 242 243 244 247 248 255 256 258 259 261 265 266 268 271 272 273 277 279 284 291 292 293 295 296 297 298 299 300 301 304 305 308 309 313 315 318 323 328 329 330 332 333 335 341 342 344 345 348 351 352 353 367 368 369 370 371 375 378 381 383 385 387 388 389 396 399 403 404 407 411 414 416 419 424 426 427 428 429 431 437 438 440 443 445 451 454 458 459 462 466 468 469 471 472 473 474 475 477 481 484 487 493 498 504 505 507 511 512 513 514 515 521 522 529 530 533 536 537 539 548 551 555 558 560 561 575 578 599 605 606 612 613 615 629 632 636 644 645 646 648 649 651 664 675 678 693 696 697 702 721 723 728 731 744 747 751 764 765 772 777 781 789 794 798 804 822 852 858 869 875 881 889 893 909 926 928 932 935 940 941 948 951 958 960 966 979 985 989 997 1001 1004 1011 1027 1041 1048 1049 1050 1056 1062 1064 1066 1067 1075 1081 1083 1085 1090 3037 168 176 204 209 224 227 245 257 262 264 269 283 286 303 307 311 320 322 324 326 339 346 355 356 360 362 365 380 382 390 391 397 398 402 415 418 420 421 423 425 430 433 434 441 442 449 450 460 463 464 470 476 478 479 480 483 485 488 490 497 499 500 502 503 510 516 544 552 556 559 563 564 566 568 570 571 574 586 587 591 592 594 595 598 602 603 604 614 616 617 623 635 638 647 650 652 655 656 658 659 663 665 666 673 674 679 680 689 692 695 698 700 705 707 709 710 712 713 715 716 719 720 722 725 726 727 732 733 734 736 738 750 755 758 763 773 780 783 785 786 787 790 792 793 795 800 801 803 807 820 821 823 824 828 835 836 837 838 842 846 848 849 856 857 859 867 870 871 872 877 879 884 886 891 894 896 898 900 903 905 907 910 912 914 918 919 922 923 924 925 933 934 950 954 955 962 963 964 965 971 972 973 974 977 978 981 982 983 984 986 988 993 996 999 1003 1006 1008 1009 1010 1013 1015 1017 1019 1026 1028 1029 1030 1031 1032 1034 1036 1037 1040 1042 1044 1045 1046 1047 1052 1053 1054 1055 1057 1058 1059 1063 1065 1069 1074 1078 1080 1086 1089 1092 1093 1095 2977 2985 2994 3000 3001 3012 3016 3019 3033 3038 3039 3815 1 2 3 4 5 6 7 8 9 10 11 12 13 14 15 16 17 18 19 20 21 22 23 26 27 28 29 32 33 34 35 39 40 41 42 43 45 46 48 50 51 53 54 55 56 58 59 60 61 62 66 67 69 70 71 77 83 93 95 98 99 100 108 110 111 112 120 127 128 129 130 134 136 138 140 141 142 149 150 157 161 162 170 172 173 175 181 185 188 191 192 194 195 202 220 229 234 237 254 260 285 287 327 336 376 395 400 408 455 546 573 596 641 699 717 769 799 811 829 831 833 855 866 882 883 888 916 930 942 944 970 980 998 1012 1023 1079 1082 1087 3022 215 219 223 239 249 252 280 343 361 392 413 486 572 588 628 684 691 724 774 778 813 818 864 874 895 945 961 967 1061 228 250 263 270 281 290 302 310 314 317 325 331 337 338 340 347 350 358 359 363 372 379 386 401 409 410 422 432 436 446 447 452 453 457 461 467 489 495 496 508 509 517 520 524 525 527 534 538 543 545 549 553 557 567 569 576 577 579 580 581 582 583 584 585 589 590 593 600 607 611 618 619 620 621 622 625 631 634 637 639 640 643 653 660 661 667 669 670 671 672 681 683 685 688 690 694 701 704 706 708 711 714 718 730 735 737 740 741 743 745 746 752 753 754 756 757 759 760 761 767 770 771 776 782 788 791 796 797 805 806 809 810 812 815 816 817 819 826 830 832 840 841 843 847 851 853 854 860 861 862 863 865 868 873 876 880 885 887 892 899 904 908 913 915 917 927 943 952 953 957 968 969 976 1000 1002 1007 1020 1024 1033 1038 1039 1051 1060 1070 1072 1073 1077 1084 2910 2911 2912 2913 2914 2915 2916 2917 2918 2919 2920 2921 2922 2923 2924 2925 2926 2927 2928 2929 2930 2931 2932 2933 2938 2939 2940 2941 2942 2943 2949 2950 2951 2952 2953 2955 2970 2971 2978 2979 2981 2982 2993 2997 3005 3007 3018 3029 3030 3034 3041 3043
}
tukand = {
	2501 2502 2503 2504 2505 2506 2507 2508 2509 2510 2511 2512 2513 2514 2515 2516 2517 2518 2519 2520 2521 2522 2523 2524 2525 2526 2527 2528 2529 2530 2531 2532 2533 2534 2535 2536 2537 2538 2539 2540 2541 2542 2543 2544 2545 2546 2547 2548 2549 2550 2551 2552 2553 2554 2555 2556 2557 2558 2559 2560 2561 2562 2563 2564 2565 2566 2567 2568 2569 2570 2571 2572 2573 2574 2575 2576 2577 2578 2579 2580 2581 2582 2583 2584 2585 2586 2587 2588 2947 2948 2976 2987 2999 3011 3020 3035 2402 2403 2404 2405 2406 2407 2408 2409 2410 2411 2412 2413 2414 2415 2416 2417 2418 2419 2420 2421 2422 2423 2424 2425 2426 2427 2428 2429 2430 2431 2432 2433 2434 2435 2436 2437 2438 2439 2440 2441 2442 2443 2444 2445 2446 2447 2448 2449 2450 2451 2452 2453 2454 2455 2456 2457 2458 2459 2460 2461 2462 2463 2464 2465 2466 2467 2468 2469 2470 2471 2472 2473 2474 2475 2476 2477 2478 2479 2480 2481 2482 2483 2484 2485 2486 2487 2488 2489 2490 2491 2492 2493 2494 2495 2496 2497 2498 2499 2500 2988 3031 3051
}
elea = {
	2761 2762 2763 2764 2765 2766 2767 2768 2769 2770 2771 2772 2773 2774 2775 2776 2777 2778 2779 2780 2781 2782 2783 2784 2785 2786 2787 2788 2789 2790 2791 2792 2793 2794 2795 2796 2797 2798 2799 2800 2801 2802 2803 2804 2805 2806 2807 2808 2809 2810 2811 2812 2813 2814 2815 2816 2817 2818 2819 2820 2821 2822 2823 2824 2825 2826 2827 2828 2829 2830 2831 2832 2833 2834 2835 2836 2837 2838 2839 2840 2841 2842 2843 2844 2845 2846 2847 2848 2849 2850 2851 2852 2853 2854 2855 2856 2857 2858 2859 2860 2861 2862 2863 2864 2865 2866 2867 2868 2869 2870 2871 2872 2873 2874 2875 2876 2877 2878 2879 2880 2881 2882 2883 2884 2885 2886 2887 2888 2889 2890 2891 2892 2893 2894 2895 2984
}
lozera = {
	2896 2897 2898 2899 2900 2901 2902 2903 2904 2905 2906 2907 2908 2909 2974 3023 1643 1673 1680 1686 1690 1695 1709 1712 1720 1723 1724 1732 1737 1738 1748 1765 1792 1795 1815 1826 1827 1834 1836 1841 1853 1860 1862 1877 1878 1883 1885 1886 1892 1897 1898 1901 1902 1903 1907 1908 1909 1913 1916 1917 1924 1927 1928 1932 1933 1935 1939 1940 1942 1944 1945 1947 1948 1951 1954 1955 1957 1959 1960 1962 1965 1967 1968 1970 1972 1973 1976 1977 1978 1979 1980 1982 1983 1986 1988 1989 1990 1993 1995 1997 1998 1999 2001 2003 2004 2005 2006 2007 2010 2011 2013 2015 2016 2018 2019 2022 2024 2025 2026 2027 2029 2031 2032 2033 2035 2036 2037 2039 2040 2041 2042 2043 2046 2047 2048 2049 2051 2052 2053 2054 2055 2056 2057 2058 2060 2061 2063 2065 2067 2068 2070 2075 2076 2081 2082 2083 2085 2086 2087 2088 2089 2090 2091 2092 2093 2094 2098 2099 2100 2102 2109 2112 2113 2119 2121 2122 2123 2124 2129 2958 2964 2968 1620 1639 1642 1643 1647 1648 1651 1654 1660 1666 1669 1670 1671 1672 1678 1679 1681 1682 1683 1685 1688 1689 1694 1696 1698 1699 1701 1702 1703 1704 1708 1710 1711 1714 1716 1717 1718 1719 1722 1726 1728 1730 1731 1733 1734 1735 1736 1739 1740 1741 1743 1744 1746 1749 1750 1752 1753 1754 1756 1757 1758 1760 1761 1762 1763 1767 1769 1772 1773 1774 1775 1776 1778 1779 1780 1781 1783 1784 1785 1787 1788 1789 1791 1794 1796 1797 1798 1800 1801 1802 1803 1805 1807 1808 1809 1810 1811 1812 1814 1816 1817 1819 1820 1821 1822 1823 1824 1825 1828 1829 1830 1831 1835 1838 1839 1843 1844 1845 1846 1847 1848 1849 1850 1851 1854 1855 1857 1858 1859 1861 1863 1864 1865 1866 1869 1870 1872 1873 1874 1875 1879 1880 1881 1884 1887 1889 1890 1891 1894 1895 1896 1900 1904 1906 1910 1911 1912 1914 1915 1919 1920 1921 1923 1925 1926 1929 1930 1934 1936 1937 1938 1943 1946 1949 1950 1952 1953 1956 1958 1961 1963 1964 1969 1971 1974 1984 1985 1987 1991 1992 1994 1996 2000 2002 2008 2009 2012 2014 2017 2020 2021 2023 2028 2030 2038 2044 2045 2050 2059 2066 2071 2073 2077 2078 2080 2096 2097 2101 2103 2107 2108 2111 2115 2116 2118 2120 2125 2127 2128 2130 2131 2990 1578 1579 1580 1581 1582 1583 1584 1585 1586 1587 1588 1589 1590 1591 1592 1593 1594 1595 1596 1597 1598 1599 1600 1601 1602 1603 1604 1605 1606 1607 1608 1609 1610 1611 1612 1613 1614 1615 1616 1617 1618 1619 1621 1622 1623 1624 1625 1626 1627 1628 1629 1630 1631 1632 1633 1634 1635 1636 1637 1638 1640 1641 1644 1645 1646 1649 1650 1652 1653 1655 1656 1657 1658 1659 1661 1662 1663 1664 1665 1667 1668 1674 1675 1676 1677 1684 1687 1691 1692 1693 1697 1700 1705 1706 1707 1713 1715 1721 1725 1727 1729 1742 1745 1747 1751 1755 1759 1764 1766 1768 1770 1771 1777 1782 1786 1790 1793 1799 1804 1806 1813 1818 1832 1833 1837 1840 1842 1852 1856 1867 1868 1871 1876 1882 1888 1893 1899 1905 1918 1922 1931 1941 1966 1975 1981 2034 2062 2064 2069 2072 2074 2079 2084 2095 2105 2106 2110 2114 2117 2126 3013 3025 2104
}
prodix = {
	2589 2590 2591 2592 2593 2594 2595 2596 2597 2598 2599 2600 2601 2602 2603 2604 2605 2606 2607 2608 2609 2610 2611 2612 2613 2614 2615 2616 2617 2618 2619 2620 2621 2622 2623 2624 2625 2626 2627 2628 2629 2630 2631 2632 2633 2634 2635 2636 2637 2638 2639 2640 2641 2642 2643 2644 2645 2646 2647 2648 2649 2650 2651 2652 2653 2654 2655 2656 2657 2658 2659 2660 2661 2662 2663 2664 2665 2666 2667 2668 2669 2670 2671 2672 2673 2674 2675 2676 2677 2678 2679 2680 2681 2682 2683 2684 2685 2686 2687 2688 2689 2690 2691 2692 2693 2694 2695 2696 2697 2698 2699 2700 2701 2702 2703 2704 2705 2706 2707 2708 2709 2710 2711 2712 2713 2714 2715 2716 2717 2718 2719 2720 2721 2722 2723 2724 2725 2726 2727 2728 2729 2730 2731 2732 2733 2734 2735 2736 2737 2738 2739 2740 2741 2742 2743 2744 2745 2746 2747 2748 2749 2750 2751 2752 2753 2754 2755 2756 2757 2758 2759 2760 2973 2995 3054
}
wuhend = {
	2132 2133 2134 2135 2136 2137 2138 2139 2140 2141 2142 2143 2144 2145 2146 2147 2148 2149 2150 2151 2152 2153 2154 2155 2156 2157 2158 2159 2160 2161 2162 2163 2164 2165 2166 2167 2168 2169 2170 2171 2172 2173 2174 2175 2176 2177 2178 2179 2180 2181 2182 2183 2184 2185 2186 2187 2188 2189 2190 2191 2192 2193 2194 2195 2196 2197 2198 2199
}
aqaecun = {
	1195 1205 1211 1216 1220 1227 1228 1233 1235 1236 1240 1241 1242 1245 1246 1247 1248 1249 1250 1251 1252 1254 1255 1257 1259 1261 1262 1263 1268 1269 1270 1271 1274 1275 1278 1279 1280 1281 1286 1287 1288 1290 1291 1292 1296 1298 1299 1302 1304 1305 1308 1309 1312 1313 1316 1318 1319 1320 1322 1323 1324 1325 1326 1328 1329 1330 1332 1333 1334 1335 1337 1342 1348 1350 1351 1362 1365 1366 1371 1378 1379 1383 1384 1386 1390 1393 1394 1397 1410 1421 1422 1423 1431 1455 1463 1467 1471 1472 1486 1506 1514 1525 1529 1530 1535 1537 1540 1542 1558 1566 1569 1572 1573 1575 2935 2936 2937 2944 2945 2946 2956 2969 3008 3044 3045 3046 3052 3053 1096 1097 1098 1099 1100 1101 1102 1103 1104 1105 1106 1107 1108 1109 1110 1111 1112 1113 1114 1115 1116 1117 1118 1119 1120 1121 1122 1123 1124 1125 1126 1127 1128 1129 1130 1131 1132 1133 1134 1135 1136 1137 1138 1139 1140 1141 1142 1143 1144 1145 1146 1147 1148 1149 1150 1151 1152 1153 1154 1155 1156 1157 1158 1159 1160 1161 1162 1163 1164 1165 1166 1167 1168 1169 1170 1171 1172 1173 1174 1175 1176 1177 1178 1179 1180 1181 1182 1183 1184 1185 1186 1187 1188 1189 1190 1191 1192 1193 1194 1196 1197 1198 1199 1200 1201 1202 1203 1204 1206 1207 1208 1209 1210 1212 1213 1214 1215 1217 1218 1219 1221 1222 1223 1224 1226 1229 1230 1231 1232 1234 1237 1238 1239 1243 1244 1256 1258 1260 1264 1265 1266 1273 1276 1285 1294 1301 1303 1314 1317 1327 1336 1339 1346 1349 1358 1367 1369 1427 1440 1488 1500 1501 1505 1508 1528 1532 1534 1541 1543 1545 1547 1550 1552 1554 1559 1560 1561 1562 1574 1577 2954 2957 2959 2960 2975 2980 2986 2992 2996 2998 3015 3024 3026 3027 3047 3049 3092 1225 1253 1267 1272 1277 1282 1283 1284 1289 1293 1295 1297 1300 1306 1307 1310 1311 1315 1321 1331 1338 1340 1341 1343 1344 1345 1347 1352 1353 1354 1355 1356 1357 1359 1360 1361 1363 1364 1368 1370 1372 1373 1374 1375 1376 1377 1380 1381 1382 1385 1387 1388 1389 1391 1392 1395 1396 1398 1399 1400 1401 1402 1403 1404 1405 1406 1407 1408 1409 1411 1412 1413 1414 1415 1416 1417 1418 1419 1420 1424 1425 1426 1428 1429 1430 1432 1433 1434 1435 1436 1437 1438 1439 1441 1442 1443 1444 1445 1446 1447 1448 1449 1450 1451 1452 1453 1454 1456 1457 1458 1459 1460 1461 1462 1464 1465 1466 1468 1469 1470 1473 1474 1475 1476 1477 1478 1479 1480 1481 1482 1483 1484 1485 1487 1489 1490 1491 1492 1493 1494 1495 1496 1497 1498 1499 1502 1503 1504 1507 1509 1510 1511 1512 1513 1515 1516 1517 1518 1519 1520 1521 1522 1523 1524 1526 1527 1531 1533 1536 1538 1539 1544 1546 1548 1549 1551 1553 1555 1556 1557 1563 1564 1565 1567 1568 1570 1571 1576 2967 3048 2961 2962
}

new_world = {}
